%%%%%%%%
%     P%
%%%    %
%    % %
%%%%%%%%